23 23 23 23 23 23 23 23 23 23 23 23 23 23 23 23 23 23 23 23 23 23 23 23 23 23 23 23 23 23 23 23 23 23 23 23 23 23 23 23 23 23 23 23 23 23 23 23 23 23 
23 23 23 23 23 23 23 37 37 37 37 37 37 37 23 23 23 23 23 23 23 23 23 23 23 23 23 23 23 23 23 23 23 23 23 23 23 23 23 37 37 37 37 37 37 37 23 23 23 23 
23 23 22 35 35 35 37 37 37 37 37 37 37 37 37 23 23 23 23 23 23 23 23 23 23 23 23 23 23 23 23 23 23 23 23 23 37 37 37 37 37 37 37 37 37 37 37 23 23 23 
23 23 23 23 23 23 37 37 37 37 37 37 37 37 37 37 23 23 23 23 23 23 23 23 23 23 23 23 23 23 23 23 23 23 37 37 37 37 37 37 37 37 37 37 37 37 37 37 23 23 
23 23 23 23 23 37 37 37 37 37 37 37 37 37 37 37 37 23 23 23 23 23 23 23 23 23 23 23 23 23 23 23 23 23 37 37 37 37 37 37 37 37 37 37 37 37 37 37 37 23 
23 23 23 23 37 37 37 37 37 37 37 37 37 37 37 37 37 37 37 23 23 23 23 23 23 23 23 23 23 23 23 23 23 23 37 37 37 37 37 37 37 37 37 37 37 37 37 37 37 37 
23 23 23 23 37 37 37 37 37 37 37 37 37 37 37 37 37 37 37 23 23 23 23 23 23 23 23 23 23 23 23 23 23 23 37 37 37 37 37 37 37 37 37 37 37 37 37 37 37 37 
23 23 23 23 37 37 37 37 37 37 37 37 37 37 37 37 37 37 37 23 23 23 23 23 23 23 23 23 23 23 23 23 23 23 37 37 37 37 37 37 37 37 37 37 37 37 37 37 37 37 
23 23 23 37 37 37 37 37 37 37 37 37 37 37 37 37 37 37 37 37 23 23 23 23 23 23 23 23 23 23 23 23 23 23 23 37 37 37 37 37 37 37 37 37 37 37 37 37 37 23 
23 37 37 37 37 37 37 37 37 37 37 37 37 37 37 37 37 37 37 37 23 23 23 23 23 23 23 23 23 23 23 23 23 23 23 37 37 37 37 37 37 37 37 37 37 37 37 37 37 23 
23 37 37 37 37 37 37 37 37 37 37 37 37 37 37 37 37 37 37 37 37 23 23 23 23 23 23 23 23 23 23 23 23 23 23 37 37 37 37 37 37 37 37 37 37 37 37 37 23 23 
23 37 37 37 37 37 37 37 37 37 37 37 37 37 37 37 37 37 37 37 37 23 23 23 23 23 23 23 23 23 23 23 23 23 23 23 37 37 37 37 37 37 37 37 37 37 37 23 23 23 
23 37 37 37 37 37 37 37 37 37 37 37 37 37 37 37 37 37 37 37 37 23 23 23 23 23 23 23 23 23 23 23 23 23 23 23 23 37 37 37 37 37 37 37 37 37 37 23 23 23 
23 37 37 37 37 37 37 37 37 37 37 37 37 37 37 37 37 37 37 37 23 23 23 23 23 23 23 23 23 23 23 23 23 23 23 37 37 37 37 37 23 37 37 37 37 23 23 23 23 23 
23 23 37 37 37 37 37 37 37 37 37 37 37 37 37 37 37 37 37 23 23 23 23 23 23 23 23 23 23 23 23 23 23 23 37 37 37 37 37 23 23 23 23 23 23 23 23 23 23 23 
23 23 23 37 37 37 37 37 37 37 37 37 37 37 37 37 37 23 23 23 23 23 23 23 23 23 23 23 23 23 23 23 23 23 37 37 37 37 23 23 23 23 23 23 23 23 23 23 23 23 
23 23 23 23 37 37 37 37 37 37 37 37 37 37 37 37 37 37 23 23 23 23 23 23 23 23 23 23 23 23 23 23 23 23 37 37 37 23 23 23 23 23 23 23 23 23 23 23 23 23 
23 23 23 23 23 23 23 23 37 37 37 37 37 37 37 37 37 37 37 23 23 23 23 23 23 23 23 23 23 23 23 23 23 23 37 37 37 23 23 23 23 23 23 23 23 23 23 23 23 23 
23 23 23 23 23 23 23 23 23 23 23 23 37 37 37 37 37 37 37 23 23 23 23 23 23 23 23 23 23 23 23 23 37 37 37 37 37 37 23 23 23 23 23 23 23 23 23 23 23 23 
23 23 23 23 23 23 23 23 23 23 23 23 23 23 23 23 21 21 21 23 23 23 23 23 23 23 23 23 23 23 37 37 37 37 37 37 37 37 37 23 23 23 23 23 23 23 23 23 23 23 
23 23 23 23 23 23 23 23 23 23 23 23 23 23 23 23 21 21 21 23 23 23 23 23 23 23 37 37 23 23 37 37 37 37 37 37 37 37 37 23 23 23 23 23 23 23 23 23 23 23 
23 23 23 23 23 23 23 23 23 23 23 23 21 21 21 21 21 21 21 21 21 23 23 23 37 37 37 37 37 23 37 37 37 37 37 37 37 37 37 23 23 23 23 23 23 23 23 23 23 23 
23 23 23 23 23 23 23 23 23 23 23 21 21 21 21 21 21 21 21 21 21 21 37 37 37 37 37 37 37 37 23 37 37 37 37 37 37 37 23 23 23 23 23 23 23 23 23 23 23 23 
23 23 23 23 23 23 23 23 23 23 21 21 21 21 21 23 23 23 23 23 21 21 37 37 37 37 37 37 37 37 37 37 37 37 37 37 37 23 23 23 23 23 23 23 23 23 23 23 23 23 
23 23 23 23 23 23 23 23 23 21 21 21 23 23 23 23 23 23 23 23 23 23 37 37 37 37 37 37 37 37 37 37 37 37 37 37 37 23 23 23 23 23 23 23 23 23 23 23 23 23 
23 23 23 23 23 23 37 37 37 37 37 23 23 23 23 23 23 23 23 23 23 23 37 37 37 37 37 37 37 37 37 37 37 37 23 23 23 23 23 23 23 23 23 23 23 23 23 23 23 23 
23 23 23 23 23 37 37 37 37 37 37 23 23 23 23 23 23 23 23 23 23 23 37 37 37 37 37 37 37 37 37 37 37 37 23 23 23 23 23 23 23 23 23 23 23 23 23 23 23 23 
23 23 23 23 37 37 37 37 37 37 37 37 23 23 23 23 23 23 23 23 23 23 37 37 37 37 37 37 37 37 37 37 37 37 23 23 23 23 23 23 23 23 23 23 23 23 23 23 23 23 
23 23 23 23 37 37 37 37 37 37 37 37 37 23 23 23 23 23 23 23 23 23 23 37 37 37 37 37 37 37 37 37 37 37 37 37 37 37 37 37 37 37 23 23 23 23 23 23 23 23 
23 23 23 23 37 37 37 37 37 37 37 37 23 23 23 23 23 23 23 23 23 23 23 23 37 37 37 37 37 37 37 37 37 37 37 37 37 37 37 37 37 37 37 23 23 23 23 23 23 23 
23 23 23 23 37 37 37 37 37 37 37 37 23 23 23 23 23 23 23 23 23 23 23 23 23 37 37 37 37 37 37 37 37 37 37 37 37 37 37 37 37 37 37 37 23 23 23 23 23 23 
23 23 23 23 23 37 37 37 37 37 37 23 23 23 23 23 23 23 23 23 23 23 23 37 37 37 37 37 37 37 37 37 23 23 23 23 23 37 37 37 37 37 37 37 37 23 23 23 23 23 
23 23 23 23 23 23 37 37 37 37 23 23 23 23 23 23 23 23 23 23 23 23 37 37 37 37 23 23 23 23 23 23 23 23 23 23 23 23 23 23 37 37 37 37 37 23 23 23 23 23 
23 23 23 23 23 23 23 23 23 23 23 23 23 23 23 23 23 23 23 23 23 23 37 37 37 23 23 23 23 23 23 23 23 23 23 23 23 23 23 23 23 23 37 37 37 21 21 23 23 23 
23 23 23 23 23 23 23 23 23 23 23 23 23 23 23 23 23 23 23 23 23 21 37 37 23 23 23 23 23 23 23 23 23 23 23 23 23 23 23 23 23 23 23 21 21 21 21 23 23 23 
23 23 23 23 23 23 23 23 23 23 23 23 23 23 37 37 37 23 23 23 23 21 21 21 23 23 23 23 23 23 23 23 23 23 23 23 23 23 23 23 23 23 23 23 21 21 21 21 23 23 
23 23 23 23 23 23 23 23 23 23 23 23 23 37 37 37 37 37 37 37 23 23 21 21 21 21 23 23 23 23 23 23 23 23 23 23 23 23 23 23 23 23 23 23 23 21 21 21 23 23 
23 23 23 23 23 23 23 23 23 23 23 23 37 37 37 37 37 37 37 37 21 21 21 21 21 21 21 21 23 23 23 23 23 23 23 23 23 23 23 23 23 23 23 23 23 23 21 21 23 23 
23 23 23 23 23 23 23 23 23 23 23 23 37 37 37 37 37 37 37 37 21 21 21 21 21 21 21 21 23 23 23 23 23 23 23 23 23 23 23 23 23 23 23 21 21 21 21 21 23 23 
23 23 23 23 23 23 23 23 23 23 23 23 37 37 37 37 37 37 37 37 37 21 21 21 21 21 21 37 37 23 23 23 23 23 23 23 23 23 23 23 23 37 37 37 37 37 37 37 37 23 
23 23 23 23 23 23 23 23 23 23 23 23 37 37 37 37 37 37 37 37 37 37 37 37 37 37 37 37 37 23 23 23 23 23 23 23 23 23 23 37 37 37 37 37 37 37 37 37 37 23 
23 23 23 23 23 23 23 23 23 23 23 23 37 37 37 37 37 37 37 37 37 37 37 37 37 37 37 37 37 37 23 23 23 23 23 23 37 37 37 37 37 37 37 37 37 37 37 37 37 23 
23 23 23 23 23 23 23 23 23 23 23 23 37 37 37 37 37 37 37 37 37 37 37 37 37 37 37 37 37 37 23 23 23 23 23 23 37 37 37 37 37 37 37 37 37 37 37 37 37 23 
23 23 23 23 23 23 23 23 23 23 23 23 37 37 37 37 37 37 37 37 37 37 37 37 37 37 37 37 37 23 23 23 23 23 23 23 37 37 37 37 37 37 37 37 37 37 37 37 23 23 
23 23 23 23 23 23 23 23 23 23 23 23 37 37 37 37 37 37 37 37 37 37 37 37 37 37 37 37 23 23 23 23 23 23 23 23 23 37 37 37 37 37 37 37 37 37 37 37 23 23 
23 23 23 23 23 23 23 23 23 23 23 23 23 37 37 37 37 37 37 37 37 37 37 37 37 37 37 37 23 23 23 23 23 23 23 23 23 37 37 37 37 37 37 37 37 37 37 23 23 23 
23 23 23 23 23 23 23 23 23 23 23 23 23 23 37 37 37 37 37 37 37 37 37 37 37 37 37 23 23 23 23 23 23 23 23 23 23 23 23 37 37 37 37 37 37 37 23 23 23 23 
23 23 23 23 23 23 23 23 23 23 23 23 23 23 23 23 23 23 23 37 37 37 37 37 37 37 23 23 23 23 23 23 23 23 23 23 23 23 23 23 23 37 37 37 37 23 23 23 23 23 
23 23 23 23 23 23 23 23 23 23 23 23 23 23 23 23 23 23 23 23 37 37 37 23 23 23 23 23 23 23 23 23 23 23 23 23 23 23 23 23 23 23 23 23 23 23 23 23 23 23 
23 23 23 23 23 23 23 23 23 23 23 23 23 23 23 23 23 23 23 23 23 23 23 23 23 23 23 23 23 23 23 23 23 23 23 23 23 23 23 23 23 23 23 23 23 23 23 23 23 23 
